partid,age,sex,rating,n_seeking,n_avoiding,s_aspects,m_aspects,m_risk,s_risk,p_control,p_social,p_situation,med_frequency,p_active,mean_sentiment,min_sentiment,max_sentiment,SMRD,aspect_ind,yearsofedu,job,income,n_aspects,remembered,similarity,duration
p01n5qi2cl,39,female,0,0,3,-3,-1,-45.333333333333336,-136,1,0,0,3,1,-1.6666666666666667,-3,-1,-1,3,13,employed,0_1k,3,0,63,298
p0g53tkf8o,34,male,8,1,0,1,1,34,34,1,0,1,3,1,-1,-1,-1,1,1,16,employed,1k_2k,1,100,86,135
p17frg3toe,29,female,7,3,0,3,1,40.333333333333336,121,1,0,0.3333333333333333,3,1,-0.5,-1,0,1,3,13,employed,0_1k,3,4,58,268
p1ro9fujga,56,female,3,0,13,-13,-1,-25.076923076923077,-326,1,0,0.23076923076923078,3,1,-1.0769230769230769,-2,0,-1,13,16,unemployed,0_1k,13,21,38,1121
p1taj15j1d,36,male,7,5,0,5,1,34.8,174,1,0,0.4,2,0.6,-0.25,-2,1,1,5,16,employed,1k_2k,5,0,46,247
p2chi38atk,33,male,2,0,2,-2,-1,-40.5,-81,1,0,0.5,3,0.5,0,0,0,-1,2,10,employed,0_1k,2,0,100,219
p2qr5d02ht,25,male,6,1,0,1,1,9,9,0,1,1,2,0,-1,-1,-1,1,1,4,employed,2k_3k,1,60,60,113
p2rebuo7c3,48,male,9,4,0,4,1,35.25,141,1,0,1,1,1,-1.5,-2,-1,1,4,14,employed,5k_x,4,62,63,342
p2ss3vbadg,25,female,3,1,3,-2,-0.5,-26,-104,0.5,0,0.5,1,1,-1,-2,0,-1,4,12,selfemployed,0_1k,4,0,63,465
p35a1ai7bf,64,male,1,0,3,-3,-1,-50,-150,0.6666666666666666,0.5,1,2.5,1,-0.3333333333333333,-2,2,-1,3,13,employed,5k_x,3,0,100,574
p3dcqbv326,29,female,7,1,1,0,0,0,0,0,0.5,1,1.5,0,1,1,1,1,2,14,selfemployed,4k_5k,2,63,66,217
p3jalp38g1,35,female,8,4,0,4,1,50,200,1,0,1,5,1,-1.25,-2,0,1,4,16,employed,1k_2k,4,29,66,262
p3st2t8d7r,34,male,3,1,3,-2,-0.5,-24.5,-98,1,0,0,1.5,1,0,-2,1,0.5,4,16,employed,2k_3k,4,27,78,236
p420mfq59t,24,male,6,1,2,-1,-0.3333333333333333,-8,-24,0,0,0,2,0.3333333333333333,-1,-2,0,1,3,16,employed,2k_3k,3,15,29,269
p42f7pvrt2,47,female,1,0,7,-7,-1,-49.714285714285715,-348,0,0,0.2,3,0.2857142857142857,-1.7142857142857142,-2,-1,-1,7,13,unemployed,2k_3k,7,0,62,1303
p4b9eblea9,35,male,8,3,0,3,1,29.333333333333332,88,1,0.3333333333333333,0,4,1,-0.6666666666666666,-1,0,1,3,16,employed,2k_3k,3,6,53,295
p4oucjvdm1,29,male,2,0,2,-2,-1,-40,-80,0.5,1,0,5.5,1,-1,-1,-1,-1,2,16,employed,1k_2k,2,0,73,316
p59eed6ltn,24,male,8,3,0,3,1,41.333333333333336,124,0.6666666666666666,0,0,3,0.6666666666666666,-1,-1,-1,1,3,17,employed,4k_5k,3,6,30,205
p5f7h569tl,45,female,1,0,8,-8,-1,-43.125,-345,0.625,0,1,2,0.625,-1.75,-2,-1,-1,8,14,employed,0_1k,8,40,38,738
p5pi6t9gsd,50,female,1,0,3,-3,-1,-39,-117,1,0,0,3,1,0.3333333333333333,-1,2,-1,3,14,unemployed,5k_x,3,1,81,357
p5po8b0u17,44,male,10,3,0,3,1,40.333333333333336,121,0.3333333333333333,0,1,2,1,0.5,0,1,1,3,16,employed,5k_x,3,2,70,279
p6k4qd8b38,33,male,1,0,2,-2,-1,-43.5,-87,0.5,0,0.5,6,0.5,-1,-2,0,-1,2,16,employed,3k_4k,2,89,81,359
p6mq9bhhpb,45,male,3,0,3,-3,-1,-31.333333333333332,-94,1,0,0,2,1,-1,-1,-1,-1,3,14,employed,2k_3k,3,29,56,3410
p6n96ubl38,55,female,6,2,0,2,1,26,52,1,1,1,3.5,0,-0.5,-1,0,1,2,12,employed,2k_3k,2,61,67,303
p74ntiluak,33,female,3,0,2,-2,-1,-41,-82,NaN,0.5,0,NA,1,-0.5,-1,0,-1,2,12,unemployed,0_1k,2,8,96,490
p75s2qi84c,57,female,1,0,10,-10,-1,-48.1,-481,0.9,0,0.2,3,1,-1.7,-2,-1,-1,10,14,employed,0_1k,10,0,100,765
p76482i33p,27,female,2,0,3,-3,-1,-38.333333333333336,-115,0.3333333333333333,0.3333333333333333,0,NA,0,-2,-3,-1,-1,3,16,employed,1k_2k,3,14,87,292
p764r6onl3,50,male,2,0,3,-3,-1,-50,-150,1,0,0.6666666666666666,5,0.5,-1.6666666666666667,-2,-1,-1,3,18,selfemployed,2k_3k,3,0,86,527
p775e7r08j,23,male,0,0,2,-2,-1,-50,-100,0,0,0,NA,1,-2.5,-3,-2,-1,2,16,employed,4k_5k,2,0,52,278
p7fh2ooref,58,female,5,6,3,3,0.3333333333333333,10.555555555555555,95,0.4444444444444444,0,1,5,1,-1.7777777777777777,-3,-1,1,9,16,retired,1k_2k,9,13,85,914
p7loem1g49,60,female,1,0,4,-4,-1,-34,-136,1,0,1,1.5,1,0,-1,1,-1,4,16,selfemployed,1k_2k,4,4,91,400
p7ola58i6r,44,female,2,0,4,-4,-1,-43.75,-175,1,0.75,0.6666666666666666,4,0.5,0,-2,1,-1,4,16,employed,0_1k,4,46,95,365
p7s0qv9m0d,36,male,7,1,1,0,0,-0.5,-1,0.5,0,1,2,1,1,1,1,1,2,18,employed,4k_5k,2,0,49,349
p7u54fcc4q,65,female,2,0,5,-5,-1,-26,-130,0,0.4,0.8,2.5,0,-0.25,-2,1,-1,5,14,employed,2k_3k,5,14,80,659
p8178lhu71,49,female,1,0,3,-3,-1,-48.666666666666664,-146,1,0,0.6666666666666666,3,0.6666666666666666,-0.6666666666666666,-2,1,-1,3,13,employed,0_1k,3,4,57,198
p81792oc4t,36,female,2,0,4,-4,-1,-49.5,-198,0,0,0,2.5,0.25,-2,-3,-1,-1,4,12,employed,2k_3k,4,0,41,410
p876nerobm,48,male,6,1,2,-1,-0.3333333333333333,1.6666666666666667,5,1,0,0,2,1,-1.3333333333333333,-2,-1,0,3,15,employed,2k_3k,3,14,78,357
p8j43n1q2e,27,female,1,0,4,-4,-1,-36.5,-146,0,0.25,0.75,5,0.75,-1,-1,-1,-1,4,14,unemployed,0_1k,4,16,67,277
p90o1dab0u,57,female,2,0,2,-2,-1,-41,-82,NaN,0,1,5,NaN,-1.5,-2,-1,-1,2,12,employed,1k_2k,2,25,73,251
p95594cp0p,37,male,8,4,0,4,1,41.25,165,0.5,0,1,2,0.75,0.25,0,1,1,4,13,employed,3k_4k,4,0,87,328
p98vdnfo6t,40,female,1,0,1,-1,-1,-38,-38,0,0,0,1,1,-3,-3,-3,-1,1,15,employed,3k_4k,1,80,86,128
paah0tgdb0,30,male,2,0,5,-5,-1,-32.8,-164,1,0,1,3,1,-1,-1,-1,-1,5,20,employed,3k_4k,5,6,59,468
pae1oh4880,32,male,0,0,1,-1,-1,-50,-50,0,0,0,2,0,-3,-3,-3,-1,1,16,employed,1k_2k,1,0,92,94
paktl8bjj7,27,female,2,0,2,-2,-1,-31,-62,1,0.5,1,1.5,1,-1.5,-2,-1,-1,2,18,employed,2k_3k,2,38,64,183
papbma6ag3,37,female,2,0,4,-4,-1,-39,-156,0.5,0.25,0.75,2,0.5,-1.75,-2,-1,-1,4,16,selfemployed,1k_2k,4,20,78,304
pbai7dfvr0,42,male,8,2,1,1,0.3333333333333333,7,21,1,0.3333333333333333,1,2,1,-1.3333333333333333,-2,0,1,3,20,employed,5k_x,3,20,55,252
pbo5rcjj99,35,female,0,0,10,-10,-1,-22.7,-227,0.2,0.5,1,2,0.8,-2.1,-3,-1,-1,10,10,employed,5k_x,10,57,59,1105
pc6644v8tl,48,female,0,1,4,-3,-0.6,-36,-180,0.5,0.2,0.6,5,0.5,-1.6,-3,0,0.6,5,13,employed,1k_2k,5,0,49,913
pcq03ude4t,43,male,6,3,0,3,1,21.666666666666668,65,1,0,1,3,1,-0.3333333333333333,-3,1,1,3,18,employed,5k_x,3,64,60,394
pcqs85n21b,43,male,1,0,4,-4,-1,-47.25,-189,1,0,0.25,1,1,-1,-2,0,-1,4,13,employed,2k_3k,4,58,89,797
pd3dvjq6g7,28,male,8,3,0,3,1,50,150,1,0,1,3,1,0,0,0,1,3,12,employed,2k_3k,3,70,70,320
pdk8em8rrq,58,female,2,2,1,1,0.3333333333333333,10.666666666666666,32,0.6666666666666666,1,1,3,0.6666666666666666,-1.6666666666666667,-3,0,0,3,14,employed,3k_4k,3,34,70,423
pdliik9kne,67,male,2,3,2,1,0.2,-6.8,-34,0.6666666666666666,0.4,0.6,4,1,-0.6,-2,0,0.8,5,16,retired,1k_2k,5,0,56,830
pdqk6hs9e4,51,female,1,0,3,-3,-1,-50,-150,1,0.3333333333333333,0.6666666666666666,1.5,1,-2.3333333333333335,-4,-1,-1,3,14,selfemployed,3k_4k,3,0,100,336
pe142cqfak,55,female,1,0,3,-3,-1,-34.333333333333336,-103,1,0.6666666666666666,0.6666666666666666,2,1,-1.3333333333333333,-2,-1,-1,3,13,retired,0_1k,3,2,84,405
pel92bgn51,34,male,1,0,4,-4,-1,-43.75,-175,0,0.5,0.5,2,0.5,0.3333333333333333,-1,1,-1,4,16,employed,2k_3k,4,55,74,221
pemvdndov1,36,female,4,2,1,1,0.3333333333333333,8,24,NaN,0,0.3333333333333333,3,1,-2,-3,-1,1,3,17,unemployed,0_1k,3,0,49,293
pf1ok9j6mf,58,female,0,3,0,3,1,50,150,0.5,0,0,4,1,-2.6666666666666665,-4,-1,1,3,16,employed,2k_3k,3,0,94,380
pf28ih4eu6,27,male,10,1,0,1,1,50,50,1,0,1,1,0,0,0,0,1,1,14,employed,5k_x,1,100,100,368
pfg9qmo3qm,69,female,3,1,2,-1,-0.3333333333333333,-26,-78,0.3333333333333333,0.3333333333333333,1,6,0,-1.3333333333333333,-3,0,-1,3,13,retired,1k_2k,3,13,75,659
pfr0l0hae0,66,male,0,0,3,-3,-1,-48.666666666666664,-146,1,1,0.6666666666666666,2,0.6666666666666666,-0.6666666666666666,-2,1,-1,3,17,employed,2k_3k,3,2,93,888
pfun3j6ut0,34,male,0,0,4,-4,-1,-34.5,-138,0.75,0,0.25,2.5,0.75,-0.5,-2,2,-1,4,18,employed,5k_x,4,0,69,383
pg3evmk92s,30,male,4,0,3,-3,-1,-28.666666666666668,-86,0.3333333333333333,0,0,4,1,-2,-3,-1,-1,3,14,employed,1k_2k,3,0,37,456
pga0e1dm62,37,male,8,4,0,4,1,28.75,115,1,0.5,0,2,1,-0.75,-1,0,1,4,26,employed,5k_x,4,25,68,548
pgjsv4g3p0,49,female,1,0,3,-3,-1,-50,-150,0.6666666666666666,0,0,1,NaN,0.3333333333333333,-1,1,-1,3,16,unemployed,5k_x,3,0,52,458
ph81j4b6fb,32,male,7,2,1,1,0.3333333333333333,16.666666666666668,50,1,NaN,1,2,0,-0.6666666666666666,-1,0,1,3,16,employed,2k_3k,3,0,14,467
phafivbdml,29,male,2,0,3,-3,-1,-38.666666666666664,-116,0,0,0.3333333333333333,2,1,-2.3333333333333335,-3,-1,-1,3,14,employed,2k_3k,3,19,71,175
pheqv1o4bi,45,male,7,2,1,1,0.3333333333333333,9.333333333333334,28,1,0,0,3,1,-1.3333333333333333,-3,0,-1,3,16,employed,5k_x,3,10,81,400
phf8vg122e,57,female,6,0,1,-1,-1,-23,-23,1,0,1,4,1,-1,-1,-1,-1,1,12,employed,1k_2k,1,39,59,173
phnc8t6ol9,28,female,2,0,3,-3,-1,-50,-150,0.3333333333333333,0,1,3,0.6666666666666666,-0.3333333333333333,-2,1,-1,3,18,employed,5k_x,3,6,74,301
php3113cce,34,male,3,0,3,-3,-1,-26,-78,0,0,0,1,0,-2,-3,-1,-1,3,16,selfemployed,0_1k,3,0,48,275
phvr676g54,66,male,1,0,3,-3,-1,-44.333333333333336,-133,1,0.3333333333333333,0,3,0,-1,-2,0,-1,3,12,selfemployed,2k_3k,3,86,90,312
pi2gguep6a,70,female,0,0,3,-3,-1,-50,-150,1,0,1,1,0.6666666666666666,-1,-1,-1,-1,3,14,retired,1k_2k,3,0,51,615
pieg7b7s35,24,female,4,2,2,0,0,-4.5,-18,0,0,0.75,5.5,0.5,-1,-3,1,0.5,4,18,employed,3k_4k,4,11,60,272
piheliu2iq,46,female,7,2,0,2,1,26,52,1,0,0,1,0.5,1.5,1,2,1,2,16,employed,2k_3k,2,37,91,249
piokq0dfpr,50,female,8,2,4,-2,-0.3333333333333333,-12.833333333333334,-77,0.25,0,0.6666666666666666,6,1,-1,-2,0,-1,6,13,employed,1k_2k,6,30,67,652
pj761a7mlo,25,female,5,3,3,0,0,-9.333333333333334,-56,0,0,0,4,NaN,-1,-2,0,-0.6666666666666666,6,19,employed,4k_5k,6,42,33,380
pjiokntims,52,female,3,1,5,-4,-0.6666666666666666,-23.5,-141,1,0,1,3,1,-0.6666666666666666,-4,2,0.6666666666666666,6,18,employed,5k_x,6,40,88,590
pjkmi6p483,25,male,8,1,0,1,1,17,17,1,0,1,2,1,0,0,0,1,1,16,employed,5k_x,1,27,75,300
pjnmqtljgr,19,male,10,4,0,4,1,36.25,145,0.75,0,0.5,3,1,-1.25,-3,0,1,4,13,student,1k_2k,4,23,61,131
pjomiut9f3,20,male,7,9,3,6,0.5,10.083333333333334,121,0.8333333333333334,0,0.4166666666666667,2,0.75,-1.1818181818181819,-6,0,0.3333333333333333,12,13,selfemployed,1k_2k,12,57,54,642
pk1i57og54,27,male,1,0,3,-3,-1,-45,-135,0.5,0,1,2,1,-1.3333333333333333,-2,0,-1,3,14,employed,2k_3k,3,0,68,332
pkovd8l667,34,female,3,2,1,1,0.3333333333333333,2.3333333333333335,7,0.3333333333333333,0,0,6,0,-1,-2,1,0,3,14,employed,4k_5k,3,9,33,520
pkpenn3v42,34,female,1,1,2,-1,-0.3333333333333333,-16.666666666666668,-50,0,0,0.3333333333333333,2,1,-2,-3,-1,1,3,16,selfemployed,0_1k,3,43,87,202
pkqk16c93v,29,female,1,0,3,-3,-1,-49.333333333333336,-148,0.3333333333333333,0,0.3333333333333333,1,0.3333333333333333,-0.6666666666666666,-2,0,-1,3,13,employed,1k_2k,3,6,73,334
pksurk0hbb,33,male,1,0,2,-2,-1,-50,-100,1,0,0,2,0,-0.5,-1,0,-1,2,13,employed,1k_2k,2,0,72,268
pktvbaqfgq,37,male,1,0,4,-4,-1,-46,-184,0.75,0.25,1,1.5,0.75,-0.6666666666666666,-2,1,-1,4,16,employed,2k_3k,4,41,70,374
pl1gu9l8m3,27,female,3,0,3,-3,-1,-35.666666666666664,-107,0,0,0,2,0,-1,-2,0,-1,3,14,employed,2k_3k,3,74,68,362
pl40upe2b5,26,female,6,3,0,3,1,15,45,NaN,0,0,5,1,-0.6666666666666666,-1,0,1,3,19,employed,3k_4k,3,6,76,237
pm4s2hpf4p,25,male,2,0,3,-3,-1,-49,-147,1,0,0,2,0.6666666666666666,-2.6666666666666665,-3,-2,-1,3,14,employed,0_1k,3,73,73,304
pmaoctfpvq,26,male,8,3,0,3,1,22.333333333333332,67,1,1,1,2,1,0.3333333333333333,-1,1,1,3,20,employed,2k_3k,3,61,42,543
pmchgjmkej,39,male,6,2,0,2,1,11.5,23,1,0,0,2,1,-1.5,-2,-1,1,2,16,employed,2k_3k,2,15,18,303
pmjahfv0dm,25,male,7,2,0,2,1,43,86,0.5,0,1,3.5,1,0.5,0,1,1,2,16,selfemployed,0_1k,2,31,73,200
pmrojsjeh0,36,female,1,0,4,-4,-1,-50,-200,0.5,0,0.25,1,0.5,-0.6666666666666666,-2,1,-1,4,13,employed,4k_5k,4,0,87,179
pn1lf5g7qc,47,male,2,0,5,-5,-1,-38.2,-191,0.4,0.5,0.4,3.5,1,-1.6,-3,1,-1,5,29,unemployed,2k_3k,5,18,10,735
pn5a9a3qva,29,female,7,3,3,0,0,0,0,0,0.16666666666666666,0.6666666666666666,4.5,0.8333333333333334,-0.6,-1,1,-0.6666666666666666,6,18,employed,2k_3k,6,0,74,361
pn73cj70pg,63,male,2,4,0,4,1,44.5,178,1,0,0,NA,1,-1.25,-3,0,1,4,16,retired,2k_3k,4,7,53,728
pncnv2dom0,60,male,9,5,0,5,1,49.4,247,1,0,1,3,1,-1,-1,-1,1,5,14,employed,2k_3k,5,20,79,681
pncs0ht0r2,26,male,10,5,0,5,1,50,250,0.6,0.6,1,2,1,-0.8,-1,0,1,5,16,employed,1k_2k,5,0,0,220
pns0bk5bpg,45,female,7,2,0,2,1,35.5,71,0,0,0.5,3,1,-0.5,-1,0,1,2,16,employed,2k_3k,2,0,45,223
pnu8ljve5b,70,male,6,2,0,2,1,15.5,31,0,0,1,3.5,1,1,1,1,1,2,15,retired,2k_3k,2,3,57,332
po2avet7op,38,female,9,0,1,-1,-1,-2,-2,0,0,1,3,1,-2,-2,-2,-1,1,15,employed,2k_3k,1,18,85,185
po45u0nri5,68,female,6,1,1,0,0,-7.5,-15,0.5,0.5,0.5,2,1,0,0,0,1,2,16,retired,2k_3k,2,21,60,483
po59r3bl5f,56,male,2,0,4,-4,-1,-31.5,-126,0.5,0,1,1.5,0.75,-1.5,-3,0,-1,4,16,employed,3k_4k,4,8,89,707
po6didsknl,30,female,1,0,7,-7,-1,-48.57142857142857,-340,1,0,0.42857142857142855,3,1,0.2,-1,2,-1,7,19,employed,3k_4k,7,7,52,1418
po9c716m7i,36,female,6,1,1,0,0,-0.5,-1,0,0.5,1,5.5,0.5,-1.5,-2,-1,-1,2,16,employed,3k_4k,2,68,37,250
pogc712epf,35,male,1,0,6,-6,-1,-49,-294,1,0,0.8333333333333334,1,1,-1,-2,0,-1,6,16,employed,2k_3k,6,10,26,500
pojroad8av,56,female,0,0,1,-1,-1,-50,-50,NaN,0,0,NA,NaN,-1,-1,-1,-1,1,12,unemployed,1k_2k,1,100,100,845
pokleml5q2,22,female,4,5,3,2,0.25,8.75,70,0.625,0.5,1,2.5,0.5,-1.125,-2,0,0.25,8,16,student,2k_3k,8,42,73,504
povck861kk,28,male,7,3,0,3,1,7.333333333333333,22,1,0.3333333333333333,0,3,0.5,-1,-2,0,1,3,17,employed,2k_3k,3,17,42,354
pp552vm3jb,53,male,2,2,3,-1,-0.2,-3,-15,0.6,0.6,1,5,0.6,-0.8,-2,0,-0.6,5,18,employed,3k_4k,5,78,100,507
ppq4ehuvoi,27,male,1,0,7,-7,-1,-45.142857142857146,-316,0.14285714285714285,0,1,3,1,-1.4285714285714286,-3,0,-1,7,16,employed,3k_4k,7,30,58,753
pr4ak5i3sl,26,female,7,5,0,5,1,40.6,203,1,0,1,4,1,1,1,1,1,5,16,employed,3k_4k,5,25,100,236
ps98rq7foh,30,male,2,0,2,-2,-1,-36.5,-73,1,0.5,0,3,1,-2.5,-3,-2,-1,2,16,employed,5k_x,2,30,78,175
psmasc3auq,33,male,6,1,0,1,1,7,7,1,0,0,3,1,-2,-2,-2,1,1,25,employed,3k_4k,1,5,32,283
pss5736g4h,24,male,10,5,0,5,1,50,250,1,0,0.8,2,1,-0.2,-2,1,1,5,16,selfemployed,5k_x,5,0,100,510
pstctu83l8,45,male,4,0,1,-1,-1,-31,-31,1,0,0,3,1,0,0,0,-1,1,14,employed,2k_3k,1,34,74,298
pt4ok81osa,22,male,0,0,1,-1,-1,-50,-50,1,0,0,6,0,1,1,1,-1,1,12,employed,2k_3k,1,76,65,140
pt8dna484n,40,male,8,2,2,0,0,0,0,1,0,0,3,0.5,-1,-2,0,0,4,16,employed,5k_x,4,37,75,486
ptfcfaaij3,24,male,9,3,0,3,1,39,117,1,0,0.6666666666666666,2,1,-0.3333333333333333,-1,1,1,3,12,employed,1k_2k,3,19,78,228
pti8q2pfad,26,male,1,0,8,-8,-1,-42.375,-339,0.2857142857142857,0.375,0.75,6,0.42857142857142855,-0.14285714285714285,-2,1,-1,8,17,employed,1k_2k,8,8,26,533
ptiaaae9ud,27,male,2,0,4,-4,-1,-49.75,-199,0.25,0,0,3.5,0,-2,-3,-1,-1,4,17,employed,1k_2k,4,12,70,540
ptqu4ourub,45,female,10,0,1,-1,-1,-50,-50,0,0,1,1,1,-2,-2,-2,-1,1,12,selfemployed,0_1k,1,27,31,277
pu5k586m01,34,male,3,0,3,-3,-1,-36,-108,1,0,1,4,0,0,-1,1,-1,3,12,selfemployed,2k_3k,3,6,78,309
pubvue9nof,33,female,0,0,1,-1,-1,-50,-50,1,0,1,1,1,-1,-1,-1,-1,1,14,employed,1k_2k,1,0,78,164
pv0evsea4b,35,female,1,0,2,-2,-1,-46.5,-93,0.5,0,0.5,2.5,1,-1.5,-2,-1,-1,2,16,selfemployed,0_1k,2,0,90,194
pv3l4i7h97,52,female,1,0,3,-3,-1,-41,-123,1,0,0.3333333333333333,1,1,-0.6666666666666666,-2,0,-1,3,16,employed,3k_4k,3,19,79,477
pvde81okc3,30,male,7,3,0,3,1,22.333333333333332,67,0,NaN,1,3,1,-0.3333333333333333,-1,0,1,3,16,employed,3k_4k,3,15,37,325
pve9ncn9s6,35,male,10,4,0,4,1,41,164,0.25,0,1,2,1,-0.75,-2,0,1,4,18,employed,5k_x,4,18,33,474
pvmdov8kus,45,male,8,3,0,3,1,46.666666666666664,140,0.6666666666666666,0.3333333333333333,1,3.5,0.6666666666666666,-1.6666666666666667,-3,-1,1,3,16,unemployed,0_1k,3,9,24,287
pvsp7i8pvn,57,female,2,0,4,-4,-1,-33.25,-133,0.75,0.25,0.3333333333333333,2,0.75,-0.75,-2,0,-1,4,17,selfemployed,1k_2k,4,6,90,943
p3lera2r97,37,female,0,0,5,-5,-1,-50,-250,0.8,0,0,1,0.8,0,-1,1,-1,5,18,employed,5k_x,5,0,100,254
pj0s9l55ia,27,female,2,0,3,-3,-1,-9.666666666666666,-29,1,0,0,3,1,1,1,1,-1,3,16,selfemployed,0_1k,3,14,28,241
p2igo6qgaa,46,female,6,3,3,0,0,-0.8333333333333334,-5,0.6666666666666666,0,1,2,1,-1,-1,-1,-0.3333333333333333,6,16,employed,3k_4k,6,0,66,379
ptoru8sg0c,32,male,5,2,4,-2,-0.3333333333333333,-4.166666666666667,-25,0.5,0.16666666666666666,0.5,3,0.8333333333333334,1,1,1,0,6,15,employed,2k_3k,6,40,68,428
pcvfb8p5b5,32,male,1,0,2,-2,-0.6666666666666666,-33.333333333333336,-100,0,0,0,NA,0,-1,-2,0,-1.25,3,12,unemployed,0_1k,3,39,73,478
pda8fk4eha,41,male,5,3,0,3,1,10.666666666666666,32,1,0.3333333333333333,1,2,1,-1,-1,-1,1,3,15,student,4k_5k,3,0,46,239
ps0k8ig481,32,male,10,3,0,3,1,43.333333333333336,130,NaN,0,0,NA,NaN,1,1,1,1,3,12,employed,3k_4k,3,0,61,417
pp6jirdmle,28,male,7,1,0,1,1,47,47,1,0,0,4,1,NaN,Inf,-Inf,1,1,16,employed,2k_3k,1,0,19,154
p2cuoibpid,25,female,3,0,3,-3,-1,-18,-54,0.6666666666666666,0,0.3333333333333333,3,0.6666666666666666,-1.5,-2,-1,-1,3,16,employed,3k_4k,3,21,78,284
pokc96mq5l,27,male,1,0,4,-4,-1,-37.75,-151,0.5,0,0.5,1,0.5,-3,-3,-3,-1,4,16,employed,1k_2k,4,21,69,243
p62e2ukh8m,32,female,1,0,2,-2,-1,-38,-76,1,0,0,1.5,0,NaN,Inf,-Inf,-1,2,24,unemployed,1k_2k,2,31,8,202
pilgv71l13,37,male,7,2,1,1,0.3333333333333333,7.333333333333333,22,0.6666666666666666,0,1,3,1,NaN,Inf,-Inf,1,3,17,employed,1k_2k,3,0,50,222
pa0ckrqnqp,24,female,2,0,4,-4,-1,-31.5,-126,0.25,1,0.75,2,0.5,-1,-1,-1,-1,4,22,student,1k_2k,4,11,88,246
p9i1pcugbb,28,male,8,3,0,3,1,41,123,0,0,1,3,1,NaN,Inf,-Inf,1,3,17,employed,5k_x,3,31,79,165
p42e0m765p,68,female,4,4,3,1,0.14285714285714285,-2.857142857142857,-20,0.6666666666666666,0.14285714285714285,1,4,1,-0.6,-2,1,1,7,14,retired,2k_3k,7,4,61,785
po0b5hvksl,33,female,7,5,0,5,1,31.6,158,0.6,0,0.4,2,0.4,-0.25,-2,1,1,5,18,employed,3k_4k,5,26,72,183
pbkjfru1lp,38,female,3,1,4,-3,-0.6,-28.8,-144,1,0,0,1,1,0,-1,1,-1,5,16,employed,3k_4k,5,0,77,442
pvojep7hrk,70,female,4,2,2,0,0,5.5,22,1,0,1,6,1,-0.3333333333333333,-1,1,-0.5,4,12,selfemployed,3k_4k,4,17,53,462
p05gc4bgi5,30,female,5,1,2,-1,-0.3333333333333333,-18.333333333333332,-55,0.6666666666666666,0,1,1,1,NaN,Inf,-Inf,0,3,16,employed,5k_x,3,17,36,122
